************
*       ****
*  * C  ****
*  * C******
* **  G ****
*   G *  ***
****   *  **
**P  C     *
*********  *
*******G   *
*******  ***
************
