************
***   ******
*GPC  ******
*** CG******
****  ******
*G**C ******
* * G ******
*C GCCG*****
*  CG  *****
**    ******
************
************
