************
*     ******
* C C *    *
*  **   * **
*  G  C   G*
* **** *** *
*    * *   *
** *   * ***
** G C    G*
***  * **  *
*P     *****
************
