************
*    *******
* C    *****
*  * C *****
* ** ** ****
*  G  G  ***
***   * P***
**  *  *****
************
************
************
************
