************
************
************
************
************
***  *******
**** G *****
**** GC ****
*****CP  ***
*****    ***
************
************
