************
*     *   **
* C * G C **
* * ** * ***
*   G   * **
*** * ******
* G   *   **
** * ** ****
* C   G C **
** *   *  **
* P**     **
************
