************
*          *
*  C       *
*    **    *
*  *  C *  *
*  *    *  *
*          *
*    * *   *
*    * *   *
*C**G*C*G*G*
******P*****
************
