***********
*GG     GG*
*GG     GG*
***  P  ***
*         *
*         *
*         *
* C C C C *
*         *
* C C C C *
*         *
***********
