************
*  *********
*    *******
* C* *******
*  G *******
* ** *******
*  G *******
*  CC   G***
*    * *****
*   ** *****
**P    *****
************